9
11
2 2 2 2 2 2 2 2 2 2 5
2 0 0 0 0 0 0 0 0 2 5
2 0 1 0 1 1 1 1 0 2 5
2 0 1 0 1 8 0 1 0 2 5
2 0 1 0 0 0 0 1 0 2 5
2 0 1 1 1 1 1 1 0 2 5
2 0 0 0 0 0 0 0 0 2 5
2 2 2 2 2 2 2 2 2 2 5
4 4 4 4 4 4 4 4 4 4 7

